222111---------112222222222222222222222222222222222222211------------112222211-----------------11222222
222111---------111222222222222222222222222222222222222111------------112222211-----------------11222222
222211----------1122222222222222222222222222222222222211-------------1112222111----------------11222222
222211----------1122222222222222222222222222222222222211--------------112222211----------------11222222
222211----------1112222222222222222222222222222222222111--------------1122222111---------------11222222
222211-----------11222222222222222222222222222222222211---------------1122222211---------------11222222
222211-----------11122222222222222222222222222222222111---------------1112222211---------------11222222
2222111-----------111222222222222222222222222222222111-----------------1112222111--------------11222222
2222211------------1111222222222222222222222222221111-------------------112222211---------------1222222
2222211--------------111112222222222222222222211111---------------------112222211---------------1222222
2222211-----------------111111222222222222111111-------------------------122222111--------------1222222
2222211---------------------1111111221111111-----------------------------122222211---------------122222
22222111-------------------------111111----------------------------------122222211---------------112222
22222211-----------------------------------------------------------------122222111----------------11122
22222211----------------------------------------------------------------112222211------------------1111
22222211----------------------------------------------------------------112222211--------------------11
222222111--------------------------------------------------------------1112222111----------------------
222222211-------------------------------------------------------------1112222211-----------------------
222222211-----------------------------------------------------------111122222211-----------------------
2222222111--------------------------------------------------------11112222221111-----------------------
2222222211----------------------------------------------------------1111221111-------------------------
22222222111-----------------------------------------------------------111111---------------------------
2222222221111-----------------------------------------------------------11-----------------------------
2222222222211111---------------------------------------------------------------------------------------
22222222222222111111-----------------------------------------------------------------------------------
2222222222222222221111111------------------------------------------------------------------------------
2222222222222222222222211111111------------------------------------------------------------------------
22222222222222222222222222222111111111---------------------------------------------------------------11
22222222222222222222222222222222222211111111--------------------------------------------------------111
2222222222222222222222222222222222222222221111111-------------------------------------------------11112
22222222222222222222222222222222222222222222222111111----------------------------------------1111111222
22222222222222222222222222222222222222222222222222211111------------------------------11111111122222222
2222222222222222222222222222222222222222222222222222221111---------------------------111222222222222222
22222222222222222222222222222222222222222222222222222222111-------------------------1112222222222222222
222222222222222222222222222222222222222222222222222222222111------------------------1122222222222222222
222222222222222222222222222222222222222222222222222222222211------------------------1112222222222222222
2222222222222222222222222222222222222222222222222222222222111------------------------111222222222222222
2222222222222222222222222222222222222222222222222222222222211-------------------------11111111122222222
2222222222222222222222222222222222222222222222222222222222211--------------------------------1111111222
22222222222222222222222222222222222222222222222222222222222211------------------------------------11112
22222222222222222222222222222222222222222222222222222222222211--------------------------------------111
222222222222222222222222222222222222222222222222222222222222111--------------------------------------11
22222222222222222222222222222222222222222222222222222222222221111--------------------------------------
22222222222222222222222222222222222222222222222222222222222222211111-----------------------------------
222222222222222222222222222222222222222222222222222222222222222222111111-------------------------------
22222222222222222222222222222222222222222222222222222222222222222222221111111--------------------------
222222222222222222222222222222222222222222222222222222222222222222222222222111111111-------------------
22222222222222222222222222222222222222222222222222222222222222222222222222222222221111111--------------
222222222222222222222222222222222222222222222222222222222222222222222222222222222222222111111----------
222222222222222222222222222222222222222222222222222222222222222222222222222222222222222222211111-------
22222222222222222222222222222222222222222222222222222222222222222222222222222222222222222222221111-----
222222222222222222222222222222222222222222222222222222222222222222222222222222222222222222222222111----
2222222222222222222222222222222222222222222222222222222222222222222222222222222222222222222222222111---
2222222222222222222222222222222222222222222222222222222222222222222222222222222222222222222222222211---
2222222222222222222222222222222222222222222222222222222222222222222222222222222222222222222222222211111